P,1,28
S,3,28
T,5,28,15,28
╔════════════════════════════════════════════════════════════════════════════════════════╗
║                                                                                        ║
║                                                                                        ║
║                                                                                        ║
║                                                                                        ║
║                                                                                        ║
║                                                                                        ║
║                                                                                        ║
║                                                                                        ║
║                                                                                        ║
║                                                                                        ║
║                                                                                        ║
║                                                                                        ║
║                                                                                        ║
║                                                                                        ║
║                                                                                        ║
║                                                                                        ║
║                                                                                        ║
║                                                                                        ║
║                                                                                        ║
║                                                                                        ║
║                                                                                        ║
║                                                                                        ║
║                                                                                        ║
║                                                                                        ║
║                                                                                        ║
║                                                                                        ║
║        ══════                                                                          ║
║                                                                                        ║
╚════════════════════════════════════════════════════════════════════════════════════════╝