P,1,28
S,8,26
T,3,2,86,28
T,85,28,3,2
B,9,25
B,45,16
R,12,7,24,7
R,65,9,73,9
R,70,5,78,5
R,77,11,81,11
R,65,14,55,14
R,12,18,24,18
R,64,20,73,20
R,24,24,14,24
╔══════╦════════════════════════════════════════════════════════════════════════════╦════╗
║      ║                                                                            ║    ║
║      ║                                                                            ║    ║
║      ║                                                                            ║    ║
║      ║                                                                                 ║
║      ║                                                                            ║    ║
║      ╠════════════════════════════════════════════════════════════════════════    ║    ║
║      ║                                                                            ║    ║
║      ║    ════════════════════════════════════════════════════════════════════════╣    ║
║      ║                                                                            ║    ║
║      ╠════════════════════════════════════════════════════════════════════        ║    ║
║      ║                                                                            ║    ║
║      ║                                                                      ══════╣    ║
║      ║                                                                            ║    ║
║      ╠═════════════════════════════════════                          ════════     ║    ║
║      ║                                             ════════════════               ║    ║
║      ║                                                                            ║    ║
║      ║                              ══════════                                    ║    ║
║      ║                                                                            ║    ║
║      ║    ════════════════════════════════════════════════════════════════════════╣    ║
║      ║                                                                            ║    ║
║      ╠════════════════════════════════════════════════════════════════════        ║    ║
║      ║                                                                            ║    ║
║      ║                                                                ══════════  ║    ║
║      ║                                                                            ║    ║
║      ║      ══════════════════════════════════════════════════════════════════════╣    ║
║      ║                                                                            ║    ║
║      ╚════════════════════════════════════════════════════════════════════════    ║    ║
░                                                                                   ║    ░
╚═══════════════════════════════════════════════════════════════════════════════════╩════╝