P,1,28
S,3,28
T,5,28,85,25
T,84,25,4,28
B,9,26
R,2,2,7,2
╔════════════════════════════════════════════════════════════════════════════════════════╗
║                                                                                        ║
║                                                                                        ║
║                                                                                        ║
║                                                                                        ║
║                                                                                        ║
║                                                                                        ║
║                                                                                        ║
║                                                                                        ║
║                                                                                        ║
║                                                                                        ║
║                                                                                        ║
║                                                                                        ║
║                                                                                        ║
║                                                                                        ║
║                                                                                        ║
║                                                                                        ║
║                                                                                        ║
║                                                                                        ║
║                                                                                        ░
║                                                        ══════                          ║
║                                                                                        ║
║                                                                                        ║
║                                            ══════                                      ║
║                                                                                        ║
║                              ══════                        ══════                      ║
║                                                      ══════                            ║
║                                                                                        ║
░                                                 ══════                                 ║
╚════════════════════════════════════════════════════════════════════════════════════════╝