P,1,28
S,3,28
T,1,2,84,1
T,84,25,4,28
B,9,26
R,2,2,7,2
╔══════════════════════════════════════════╦═════════════════════════════════════════════╗
║                                          ║                                             ║
║        ════════                          ║                                 ════════    ║
║                          ═════           ║                                             ║
║                                          ║                                             ║
║                                 ═════    ║                                             ║
║                                          ║                                             ║
║                            ═════         ║                                             ║
║                                          ║                                             ║
║           ═════      ═════               ║                                             ║
║                                          ║                                             ║
╠═══  ═════                                ║                                             ║
║                                          ║                                             ║
║           ══════                         ║                                             ║
║                                          ║                                             ║
║                  ══════                  ║                                             ║
║                                          ║                                             ║
║                          ══════          ║                                             ║
║                                          ║                                             ║
║                    ══════                ║                                             ░
║                                          ║             ══════                          ║
║                           ══════         ║                                             ║
║                                          ║                                             ║
║                                    ══════╬══════                                       ║
║                                          ║                                             ║
║                  ══════      ══════      ║                 ══════                      ║
║                                          ║          ══════                             ║
║         ══════                           ║                                             ║
░                                          ║      ══════                                 ║
╚══════════════════════════════════════════╩═════════════════════════════════════════════╝