P,1,28
S,3,28
T,5,28,85,25
T,84,25,4,28
B,9,26
R,60,19,80,19
R,50,28,84,28
╔════════════════════════════════════════════════════════════════════════════════════════╗
║                                                                                        ║
║                                                                                        ║
║                                                                                        ║
║                                                                                        ║
║                                                                                        ║
║                                                                                        ║
║                                                                                        ║
║                                                                                        ║
║                                                                                        ║
║                                                                                        ║
║                                                                                        ║
║                                                                                        ║
║                                                                                        ║
║                                                                                        ║
║                                                                                        ║
║                                                                                        ║
║                                                                                        ║
║                                                                                        ║
║                                                                                        ░
║                                                        ══════  ══════  ══════     ═════║
║                                                                                        ║
║                                                  ══════                                ║
║                                            ══════                                      ║
║                                                                                        ║
║                              ══════                                                    ║
║                                                                                        ║
║                  ════════════                                                          ║
░                                                                                        ║
╚════════════════════════════════════════════════════════════════════════════════════════╝