P,1,2
T,80,28,4,2
S,81,28
R,56,2,45,2
R,13,5,24,5
R,56,8,45,8
R,13,11,24,11
R,56,14,45,14
R,13,17,24,17
R,56,20,45,20
R,13,23,24,23
R,27,26,35,26
B,22,27
B,41,27
╔════════════════════════════════════════════════════════════════════════════════════════╗
║                                                                                        ║
░                                                                                        ║
╠══════════════════════════════════════════════════════════                              ║
║                                                                                        ║
║                                                                                        ║
║            ════════════════════════════════════════════════════════════════════════════╣
║                                                                                        ║
║                                                                                        ║
╠══════════════════════════════════════════════════════════                              ║
║                                                                                        ║
║                                                                                        ║
║            ════════════════════════════════════════════════════════════════════════════╣
║                                                                                        ║
║                                                                                        ║
╠══════════════════════════════════════════════════════════                              ║
║                                                                                        ║
║                                                                                        ║
║            ════════════════════════════════════════════════════════════════════════════╣
║                                                                                        ║
║                                                                                        ║
╠══════════════════════════════════════════════════════════                              ║
║                                                                                        ║
║                                                                                        ║
║            ════════════════════════════════════════════════════════════════════════════╣
║                                                                                        ║
║                                                                                        ║
║                          ╔═════════╗                                                   ║
║                    ═══   ║         ║  ═══                                              ░
╚══════════════════════════╩═════════╩═══════════════════════════════════════════════════╝