P,1,2
╔════════════════════════════════════════════════════════════════════════════════════════╗
║                                                                                        ║
░                                                                                        ║
╠══════════════════════════════════════════════════════════                              ║
║                                                                                        ║
║                                                                                        ║
║            ════════════════════════════════════════════════════════════════════════════╣
║                                                                                        ║
║                                                                                        ║
╠══════════════════════════════════════════════════════════                              ║
║                                                                                        ║
║                                                                                        ║
║            ════════════════════════════════════════════════════════════════════════════╣
║                                                                                        ║
║                                                                                        ║
╠══════════════════════════════════════════════════════════                              ║
║                                                                                        ║
║                                                                                        ║
║            ════════════════════════════════════════════════════════════════════════════╣
║                                                                                        ║
║                                                                                        ║
╠══════════════════════════════════════════════════════════                              ║
║                                                                                        ║
║                                                                                        ║
║            ════════════════════════════════════════════════════════════════════════════╣
║                                                                                        ║
║                                                                                        ║
║                          ╔═════════╗                                                   ║
║                    ═══   ║         ║  ═══                                              ░
╚══════════════════════════╩═════════╩═══════════════════════════════════════════════════╝