P,1,28
T,9,1,84,28
T,85,28,10,1
╔══════════════════════════════════════════╦═════════════════════════════════════════════╗
║                                          ║                                             ░
║        ════════════                      ║                            ═════════════════╣
║                      ═════════           ║                   ══════                    ║
║                                          ║                                             ║
║                                 ═════    ║                          ══════             ║
║                                          ║                                             ║
║                            ═════         ║                   ══════                    ║
║                                          ║                                             ║
║           ═════    ═══════               ╠══════════════════                           ║
║                                          ║                                             ║
╠══════════                                ║                    ══════                   ║
║                                          ║                           ══════            ║
║           ══════                         ║                                 ══════      ║
║                                          ║                                             ║
║                  ══════                  ║                                       ══════╣
║                                          ║                                             ║
║                          ══════          ║                     ══════════════════      ║
║                                          ║                                             ║
║                    ══════                ║               ══════                        ║
║                                          ║                                             ║
║                           ══════         ║        ══════                               ║
║                                          ║                                             ║
║                                    ══════╬══════                                       ║
║                                          ║                                             ║
║                  ════════════════        ║       ══════                                ║
║                                          ║          ══════                             ║
║         ══════                           ║                                             ║
░                                          ║                 ══════                      ║
╚══════════════════════════════════════════╩═════════════════════════════════════════════╝