P,1,28
R,1,5,25,5
R,6,14,23,14
R,47,16,63,16
S,67,28
R,71,14,82,14
R,28,24,43,24
T,53,13,48,22
T,47,22,54,13
B,36,20
╔═══════════╦═══════════════════════╦════════════════════════════╦═══════════════════════╗
║           ║                       ║                            ║                       ║
║        ═══╬════                                                            ════════    ║
║           ║              ═════    ║                            ║                       ║
║           ║                       ║       ══════════           ║                       ║
║                                 ══╩══                   ═══════╬═══════                ║
╠════════════════════════                                        ║                       ║
║                            ═════                               ║                       ║
║                                                 ═══════        ║                       ║
║           ═════      ═════                                     ║             ══════════╣
║                                        ══════                  ║                       ║
╠═══  ═════                                                      ║                  ║    ║
║                             ══════════     ╠═════╦═════════╗   ║                  ║    ░
║           ══════                           ║     ║             ║                  ╠═   ║
║                                                  ╠═══════╗     ║                  ║    ║
║    ════════════════════              ══════╣     ║             ║    ╔═════════════╝    ║
║                                            ║                   ║    ║                 ═╣
║                          ══════            ╠═══════════════════╣    ║                  ║
║                                            ║                   ║    ║            ════  ║
║         ═══════════════  ═══════    ═══════╣                   ║    ║                  ║
║                                            ║                   ║    ║          ══      ║
║     ════════════          ═══════════      ║                   ║    ║                  ║
║                                            ║                   ╝    ╚  ══════════      ║
╠══════════════════════════            ══════╬═════════                                  ║
║                                            ║            ══════         ╔═╗             ║
║          ═══════════     ══════════════════╣                         ══╝ ║             ║
║                                            ║                             ║             ║
╠═══════════════════════                     ║    ════════                ╔╩╗            ║
░                                            ║                           ╔╝ ╚╗           ║
╚════════════════════════════════════════════╩═══════════════════════════╩═══╩═══════════╝