P,1,28
R,37,11,52,13
R,14,20,74,22
R,74,2,14,4
B,81,3
B,76,4
B,71,5
B,66,6
B,61,7
B,56,8
B,51,9
B,79,18
B,74,17
B,69,16
B,64,15
B,59,14
B,54,13
S,21,16
S,25,15
╔════════════════════════════════════════════════════════════════════════════════════════╗
║                                                                                        ║
║                                                                                        ░
╠═════          ═════════════════════════════════════════════════════════           ═════╣
║     ═════                                                                    ═════     ║
║          ═════                                                          ═════          ║
║               ═════                                                ═════               ║
║                    ═════                                      ═════                    ║
║                         ═════                            ═════                         ║
║                              ═════                  ═════                              ║
║                                   ═════        ═════                                   ║
║                                                                                        ║
║                                      ═════════════                                     ║
║                                                                                        ║
║                                 ═════             ═════                                ║
║                            ═════                       ═════                           ║
║                       ═════                                 ═════                      ║
║                  ═════                                          ═════                  ║
║             ═════                                                    ═════             ║
║       ══════                                                              ══════       ║
║                                                                                        ║
╠══════          ════════════════════════════════════════════════════════          ══════╣
║      ═════                                                                  ═════      ║
║           ═════                                                        ═════           ║
║                ═════                                              ═════                ║
║                     ═════                                    ═════                     ║
║                          ═════                          ═════                          ║
║                               ═════                ═════                               ║
░                                                                                        ║
╚════════════════════════════════════════════════════════════════════════════════════════╝