P,1,28
╔════════════════════════════════════════════════════════════════════════════════════════╗
║                                                                                        ║
║                                                                                        ░
║═════          ═════════════════════════════════════════════════════════           ═════║
║     ═════                                                                    ═════     ║
║          ═════                                                          ═════          ║
║               ═════                                                ═════               ║
║                    ═════                                      ═════                    ║
║                         ═════                            ═════                         ║
║                              ═════                  ═════                              ║
║                                   ═════        ═════                                   ║
║                                                                                        ║
║                                      ═════════════                                     ║
║                                                                                        ║
║                                 ═════             ═════                                ║
║                            ═════                       ═════                           ║
║                       ═════                                 ═════                      ║
║                  ═════                                          ═════                  ║
║             ═════                                                    ═════             ║
║       ══════                                                              ══════       ║
║                                                                                        ║
║══════          ════════════════════════════════════════════════════════          ══════║
║      ═════                                                                  ═════      ║
║           ═════                                                        ═════           ║
║                ═════                                              ═════                ║
║                     ═════                                    ═════                     ║
║                          ═════                          ═════                          ║
║                               ═════                ═════                               ║
░                                                                                        ║
╚════════════════════════════════════════════════════════════════════════════════════════╝